| | | | | | | | | | | | | | | |

| | | | - X - | | - X - | | | |

| | | | - - - | | - - - | | | |

| | | | - - - | | - - - | | | |

| | | | - - - | | - - - | | | |

| | | | - - - | | - - - | | | |

| | | | - - - | | - - - | | | |

| | | | - P - | | - F - | | | |

| | | | | | | | | | | | | | | |