O O O O O O O O O O O O O O O O

O O O O B1 X2 B3 O O -1 X2 -3 O O O O

O O O O -5 B6 -7 O O B5 -6 B7 O O O O

O O O O B5 -6 B7 O O -5 B6 -7 O O O O

O O O O -5 B6 -7 O O B5 -6 B7 O O O O

O O O O B5 -6 B7 O O -5 B6 -7 O O O O

O O O O -5 B6 -7 O O B5 -6 B7 O O O O

O O O O B9 P10 B11 O O -9 F10 -11 O O O O

O O O O O O O O O O O O O O O O